%%%%%%%%
%   PG %
%G%%%%%%
%    . %
%%%%%%%%